##########################
# #                    # #
#                      # #
#                      # #
#                      # #
#   #                  # #
#   #   #############  # #
#   #   #           #    #
#   #   #           #    #
#   #   #           #    #
#   #   #           #    #
#   #   #           #    #
#   #   #           #    #
#   #   # ############   #
#   # # #    #      #    #
#   # # #    #      # #  #
#   # # #    #      # #  #
#   # # #    #      # #  #
#   # #      #      # #  #
#   # #      # #### # #  #
#   # #      #      # #  #
#   # #      #      # #  #
#     #      #      # #  #
#     #      #      # #  #
#     #             # #  #
#     #             # #  #
#     #        #    # #  #
#   # #        # #### #  #
#   # #        #      #  #
#   # #   #    #      #  #
#   # #        #      #  #
#   # #        #      #  #
#   # #        #      #  #
#   # #        #      #  #
#   # #   #############  #
#   # #   #      #       #
#   # #   #      #       #
#   # #   #      #       #
#   # #   #      #   #   #
#   # #   #  #   #   #   #
#   # #   #  #   #   #   #
#     #      #       #   #
#     #      #           #
#     #      #           #
#     #      #           #
##########################